LH 	名 	な
LHH 	水 	みず
LHHH 	会社 	かいしゃ
LHHHH 	大学 	だいがく
LHHHHH 	中国語 	ちゅうごくご
LHHHHHH 	見物人 	けんぶつにん
LHHHHHHH 	五十音順 	ごじゅうおんじゅん
LHHHHHHHH 	いい加減にしろ 	いいかげんにしろ
HL 	木 	き
HLL 	秋 	あき
HLLL 	電気 	でんき
HLLLL 	文学 	ぶんがく
HLLLLL 	シャーベット 	しゃーべっと
HLLLLLL 	ケンモホロロ 	けんもほろろ
HLLLLLLL 	呉越同舟 	ごえつどうしゅう
LHL 	花 	はな
LHLL 	お菓子 	おかし
LHLLL 	雪国 	ゆきぐに
LHLLLL 	普及率 	ふきゅうりつ
LHLLLLL 	お巡りさん 	おまわりさん
LHHL 	男 	おとこ
LHHLL 	歳時記 	さいじき
LHHLLL 	山登り 	やまのぼり
LHHLLLL 	金婚式 	きんこんしき
LHHLLLLLL 	副大統領 	ふくだいとうりょう
LHHHL 	弟 	おとうと
LHHHLL 	小型バス 	こがたばす
LHHHLLL 	国語辞典 	こくごじてん
LHHHLLLL 	私立大学 	しりつだいがく
LHHHHL 	桃の花 	もものはな
LHHHHLL 	炭酸ガス 	たんさんがす
LHHHHLLL 	幼年時代 	ようねんじだい
LHHHHLLLL 	大学院生 	だいがくいんせい
LHHHHHL 	十一月 	じゅういちがつ
LHHHHHL 	お願いします 	おねがいします
LHHHHHLLL 	自動販売機 	じどうはんばいき
LHHHHHHLL 	携帯ストラップ 	けいたいすとらっぷ
LHHHHHHHHHL 	宜しくお願いします 	よろしくおねがいします
